00000000000000000000
11112221111111111220
11111111111111111220
11111111110000000000
11111111110222111111
11111111110221111111
00000000000211111111
01111111111111111111
01111111111111111111
01111111111111111111
02221111111111111111
00000000000000011111
11111111111111000000
