00000000000000000000
11222111111111111110
11111112222111111110
11111111111111111110
00000000000000000000
01122111111111222111
01111111111111111111
01111112211111111111
00000000000000000000
11111111111122111110
00000000000000000000
01111122111111111111
00000000000000000000
