00000000000111111111
11111111110111111111
11111111110111111111
11111111110111111111
11111111110111111111
11111111110111111111
11111111110111111111
11111111110111111111
11111111110111111111
11111111110111111111
11111111110111111111
11111111110111111111
11111111110000000000
