00000000000112111111
11111211110111122211
11222211110111111111
11111111110111111111
11111111110111111111
11122211110111111111
11111111110111111111
11111111110111111111
22111111110111111111
11111111110112222221
11112111110111111111
11111111110111111111
11111111110000000000
