00111221112222111111
10012221122111121111
11001112221112221111
11100122221121112221
11110011121111121111
11211001111122122111
11111100111111111111
12211110021112211111
22111111001111111111
11112221100000011111
22211122111112000111
11221111222111110001
11111122221111111100
