00111111111111111111
10011111122111111111
11001111111111111111
11100122221111111111
11110011121111111111
11111001111122111111
11111100111111111111
11111110021112211111
11111111001111111111
11112221100000011111
11111122111112000111
11221111111111110001
11111111111111111100
