00000000000000000000
01111111111111111110
01111111111122111110
01111122221111111110
01111111121111111110
01111211111122111110
01111111111111111110
01111111121112211110
01111111111111111110
01112221111111111110
01111122111112111110
01221111111111111110
00000000000000000000
