00111221111111111111
10011111122111111111
11001112211112221111
11100122221121111111
11110011121111111111
11111001111122122111
11111100111111111111
11111110021112211111
22111111001111111111
11112221100000011111
22211122111112000111
11221111111111110001
11111122221111111100
